Ed Sheeran - Perfect
Ed Sheeran - Thinking Out Loud
John Legend - All of Me
Adele - Someone Like You
Adele - Hello
Sam Smith - Too Good At Goodbyes
Billie Eilish - Ocean Eyes
Billie Eilish - Lovely
Lewis Capaldi - Someone You Loved
Bruno Mars - Talking to the Moon
Coldplay - Fix You
Coldplay - Yellow
Harry Styles - Sign of the Times
Justin Bieber - Love Yourself
Shawn Mendes - Mercy
James Arthur - Say You Won't Let Go
Passenger - Let Her Go
The Fray - How to Save a Life
Snow Patrol - Chasing Cars
One Direction - Little Things
Zayn - Dusk Till Dawn
Sia - Helium
Rihanna - Stay
Lady Gaga - Shallow
Christina Perri - A Thousand Years
Jason Mraz - I Won't Give Up
Bruno Mars - Just the Way You Are
Train - Drops of Jupiter
Maroon 5 - She Will Be Loved
Hoobastank - The Reason
Evanescence - My Immortal
Linkin Park - One More Light
Guns N' Roses - November Rain
Aerosmith - I Don't Want To Miss A Thing
The Police - Every Breath You Take
U2 - With Or Without You
Bryan Adams - Heaven
Whitney Houston - I Will Always Love You
Celine Dion - My Heart Will Go On
Elvis Presley - Can't Help Falling in Love
Frank Sinatra - Fly Me To The Moon
Louis Armstrong - What a Wonderful World
Ben E. King - Stand By Me
The Beatles - Let It Be
John Lennon - Imagine
Bob Dylan - Knockin' on Heaven's Door
Leonard Cohen - Hallelujah
Don McLean - Vincent
James Taylor - You've Got a Friend
Norah Jones - Don't Know Why
Etta James - At Last
Aretha Franklin - Natural Woman
Otis Redding - Dock of the Bay
Sam Cooke - A Change Is Gonna Come
Al Green - Let's Stay Together
Marvin Gaye - What's Going On
Bill Withers - Ain't No Sunshine
Stevie Wonder - Lately
Prince - Purple Rain
George Michael - Careless Whisper
Sade - Smooth Operator
Michael Jackson - Human Nature
Lionel Richie - Hello
Commodores - Easy
Bee Gees - How Deep Is Your Love
Carpenters - Close to You
Simon & Garfunkel - Bridge Over Troubled Water
Cat Stevens - Father and Son
Joni Mitchell - Both Sides Now
Fleetwood Mac - Songbird
Elton John - Tiny Dancer
Billy Joel - Vienna
Eagles - Desperado
Kansas - Dust in the Wind
America - A Horse With No Name
Don Henley - Boys of Summer
Foreigner - I Want to Know What Love Is
Chicago - You're the Inspiration
REO Speedwagon - Keep on Loving You
Journey - Faithfully
Toto - Africa (Acoustic)
Cyndi Lauper - Time After Time
Bangles - Eternal Flame
Madonna - Crazy for You
Wham! - Last Christmas
Phil Collins - In the Air Tonight
Sting - Fields of Gold
R.E.M. - Everybody Hurts
Oasis - Wonderwall
The Verve - Bitter Sweet Symphony
Snow Patrol - Run
Keane - Bedshaped
Travis - Sing
Radiohead - High and Dry
Jeff Buckley - Hallelujah
Red Hot Chili Peppers - Under the Bridge
Nirvana - Something in the Way
Pearl Jam - Just Breathe
Soundgarden - Black Hole Sun (Acoustic)
Stone Temple Pilots - Plush (Acoustic)
Alice in Chains - Nutshell
Foo Fighters - Everlong (Acoustic)
Green Day - Good Riddance
Blink-182 - I Miss You
Incubus - Drive
3 Doors Down - Here Without You
Lifehouse - Hanging by a Moment
The Calling - Wherever You Will Go
Goo Goo Dolls - Iris
Matchbox Twenty - Unwell
Daughtry - Home
Five for Fighting - 100 Years
Daniel Powter - Bad Day
Howie Day - Collide
The Fray - You Found Me
OneRepublic - Apologize
Timbaland - Apologize
Leona Lewis - Bleeding Love
Beyonce - Halo
Alicia Keys - If I Ain't Got You
Usher - Burn
Mariah Carey - We Belong Together
Ne-Yo - So Sick
Chris Brown - With You
Rihanna - Take a Bow
Katy Perry - The One That Got Away
Taylor Swift - All Too Well
Taylor Swift - Safe and Sound
Lana Del Rey - Video Games
Lana Del Rey - Summertime Sadness
Lorde - Ribs
Halsey - Sorry
Julia Michaels - Issues
Camila Cabello - Consequences
Ariana Grande - almost is never enough
Selena Gomez - Lose You to Love Me
Demi Lovato - Stone Cold
Miley Cyrus - The Climb
Kelly Clarkson - Because of You
Carrie Underwood - Jesus Take the Wheel
Rascal Flatts - Bless the Broken Road
Lady A - Need You Now
Lonestar - Amazed
Shania Twain - You're Still the One
Faith Hill - Breathe
Dixie Chicks - Landslide
Brad Paisley - Whiskey Lullaby
Tim McGraw - Humble and Kind
Kenny Chesney - There Goes My Life
Alan Jackson - Remember When
George Strait - I Cross My Heart
Garth Brooks - The Dance
Brooks & Dunn - Believe
Johnny Cash - Hurt
Willie Nelson - Always on My Mind
Dolly Parton - I Will Always Love You
Loretta Lynn - Coal Miner's Daughter
Patsy Cline - Crazy
Hank Williams - I'm So Lonesome I Could Cry
Ray Charles - Georgia on My Mind
Nina Simone - Feeling Good
Ella Fitzgerald - Misty
Billie Holiday - Strange Fruit
Sarah Vaughan - Misty
Nat King Cole - Unforgettable
Dean Martin - That's Amore
Tony Bennett - I Left My Heart in San Francisco
Judy Garland - Over the Rainbow
Julie Andrews - Edelweiss
Barbra Streisand - The Way We Were
Bette Midler - The Rose
Sarah McLachlan - Angel
Dido - White Flag
Jewel - You Were Meant for Me
Sheryl Crow - Strong Enough
Alanis Morissette - Ironic
Cranberries - Linger
No Doubt - Don't Speak
Sixpence None the Richer - Kiss Me
Natalie Imbruglia - Torn
Savage Garden - Truly Madly Deeply
Backstreet Boys - I Want It That Way
NSYNC - This I Promise You
98 Degrees - I Do
Westlife - My Love
Boyz II Men - End of the Road
K-Ci & JoJo - All My Life
Brian McKnight - Back at One
Luther Vandross - Dance with My Father
Peabo Bryson - A Whole New World
James Ingram - Just Once
Jeffrey Osborne - On the Wings of Love
Lionel Richie - Stuck on You
Stevie Wonder - I Just Called to Say I Love You
Michael Jackson - She's Out of My Life
Prince - Diamonds and Pearls
Sade - No Ordinary Love
Anita Baker - Sweet Love
Whitney Houston - Greatest Love of All
Mariah Carey - Vision of Love
Celine Dion - The Power of Love